1111111111111
1001000000000
100001000E001
1P0C010000001
1111110000000