1111111111111111111111111111111111
1E0000000000000C000W0C0000000000W1
10100101001000001010010W0000010101
1010W1001010101W001001000W00010101
1P00000W0C00C00000000000000W0000C1
1111111111111111111111111111111111