1111111111111111111111111111111111
1E0000000W000000000000000000C00001
101001010010C000101001000C00010101
1010010010101W10001001000000010101
10000W0000C000000000000000P0000001
1111111111111111111111111111111111