111111111111
100000000001
1P000000CE01
111111111111