1111111111111111111111111111111111
1E0000000000000C00000C000000000C01
101001010010000W1W1001000000W10101
11100100101000100C1001000PP010101
100000000C01C100000C000100000000C1
1111111111111111111111111111111111