1111111111111111111111111111111111
1E00000000000W0C00000C00000W000C01
10100101001000W01010010000W0010101
11100100101000100C1001000P00010101
100W00W00C01C100W00C000100000000C1
1111111111111111111111111111111111